


1111111111111111111
1111111100011111111
111111110C011111111
1111111100011111111
1111111110111111111
1111111110111111111
111111A0A0000111111
1111110A00000111111
100011A0A0000110001
10C000000E000000C01
1000110000000110001
1111110000000111111
1111110000000111111
1111111110111111111
1111111110111111111
1111111100011111111
111111110P011111111
1111111100011111111
1111111111111111111


